#####################
#A----#-----#-#-----#
#-#-#-#-###---#-#-###
#-#-#---#---#---#---#
###-#####-#####-###-#
#---#---------#-#---#
#-###-#######-###-#-#
#---#-#---#---#---#-#
###-#---#-###-#-#####
#---#-#-#---#-#-#---#
#-#####-###-#-#-#-#-#
#-----#---#-#-#---#-#
#-###-###-###-#####-#
#-#-----#---#---#---#
#-#-#######-###-#-#-#
#-#-------#-#-#---#-#
#-#######-#-#-#####-#
#-#-----#---#-#-----#
#-#-###-#####-#-#####
#-----#-------------#
#####################