##########
#-A----A-#
#--------#
#--------#
#--------#
#--------#
#--------#
#--------#
#-A----A-#
##########