##########
#-A-##-A-#
#-#-##-#-#
#-#-##-#-#
#--------#
#---##---#
#-#-##-#-#
#-#----#-#
#-A-##-A-#
##########