###############
#A-XXXXXXXXX-A#
#-#X#-#X#-#X#-#
#XX-X-XXXX-XXX#
#X#X#-#X#-#X#-#
#XX-XX-XX-X-XX#
#X#-#X#-#X#-#X#
#XX-XXX--XX-XX#
#X#X#-#-#X#-#X#
#XX---XXXXX-XX#
#-#-#X#-#X#-#X#
#X-XX--XXX--XX#
#-#X#X#-#X#-#-#
#A-XXXXXXXXX-A#
###############