##########
#--------#
#--------#
#--------#
#---A----#
#--------#
#--------#
#--------#
#--------#
##########