#############
#---#---#---#
#---#-----#-#
###-------#-#
#-#-#---#---#
#-####--###-#
#---A-------#
#-#-#######-#
#-#----#----#
#-#-#-##--#-#
#-##--##-##-#
#-----------#
#############