##########################################
##--------------##----------------------##
######--######--##--#########-########--##
##------##----------##--------------##--##
##--##################--##########--##--##
##----------------------##----------##--##
##--############-#########--##########--##
##------##------------------##------##--##
##########--##################--######--##
##----------##------##----------##------##
##--##########--##--##---#--##--##--######
##--##----------##--##---#--##--##------##
##--##--##########--##---#--##########--##
##--##----------##--A----#--##------##--##
##--##########--##########--##--##--##--##
##----------##--##--------------##--##--##
##########--##--##################--##--##
##----------##------------------##--##--##
##--##########################--##--##--##
##------------------------------##------##
##########################################