#############
#---#---#---#
#-#-#-#-#-#-#
###---#---#-#
#-#-#---#---#
#-####--###-#
#---A-----#-#
#-#-#######-#
#-#---##----#
#-#-#-##--#-#
#-###-##-##-#
#-----------#
#############