##########
#-----#--#
#-#---#--#
#-#-#----#
#--A#--#-#
#---#----#
###---##-#
#---#-#--#
#---#----#
##########