#-###############################
#---#-#-----#-----#---#-#-#-----#
#-#-#-#-#####-#######-#-#-#-#-###
#-#---#---#-----#-------#---#---#
#-###-#-#####-###-#######-#-#-#-#
#-#-#-------------#-------#-#-#-#
###-#-#-###-###-#####-#####-#####
#-----#-#-----#-#-------------#-#
#####-#########-###-#####-#-###-#
#---#-#-#-#-------#-#---#---#---#
#-##--------------#-###-###-###-#
#-#-#-----#-#---#---#---#-#-----#
#-#-#-###-#-#-#####-#-###-#-#####
#-----#---#---#-------#---------#
#-#-###-#-----------#-#-#####-###
#-#-#---#-#---A-#-#-#-#-----#---#
#-#-###-##--------#-#######-#-###
#-#---#---#-#-----#---#-#---#---#
#-#-#-#-#-#---------###-###-#####
#-#-#-#-#-#---#-----#-#---#-----#
###---------#####-#-#-#-###-#-#-#
#---#-#-#---------#-----#-#-#-#-#
#-#-#-#-#####-#-#-###-###-#######
#-#---#---#---#-#---------#-#-#-#
#-#-#-#-#-#-#####-#-###-#-#-#-#-#
#-#-#-#-#-#---#-#-#---#-#-#-----#
###-#----------------##-###-###-#
#-#-#---#-------#-#-#---#-#-#---#
#-#-#-#-###-#-#-###-###-#-###-###
#---#-#-#---#-#-#-#---------#---#
###-#-#-###-###-#-#-###-#-#-#-###
#---#-#-#-----#-#---#---#-#-----#
###############################-#
